//MAP CONVERTED BY dmm2tgm.py THIS HEADER COMMENT PREVENTS RECONVERSION, DO NOT REMOVE
"a" = (
/turf/template_noop,
/area/template_noop)
"b" = (
/turf/closed/wall/mineral/titanium,
/area/shuttle/arrival)
"c" = (
/obj/machinery/door/airlock/titanium{
	name = "Arrivals Shuttle Airlock"
	},
/obj/structure/fans/tiny,
/obj/effect/turf_decal/stripes/line,
/obj/effect/turf_decal/trimline/neutral/filled/warning{
	dir = 1
	},
/turf/open/floor/iron/textured_large,
/area/shuttle/arrival)
"d" = (
/obj/effect/spawner/structure/window/reinforced/shuttle,
/obj/structure/fans/tiny/invisible,
/turf/open/floor/plating,
/area/shuttle/arrival)
"e" = (
/obj/structure/table,
/obj/item/storage/medkit/regular,
/obj/effect/turf_decal/trimline/neutral/filled/warning/corner{
	dir = 4
	},
/turf/open/floor/iron,
/area/shuttle/arrival)
"f" = (
/obj/structure/chair/comfy/shuttle{
	dir = 4
	},
/obj/effect/turf_decal/trimline/neutral/filled/line{
	dir = 8
	},
/obj/effect/turf_decal/trimline/neutral/filled/mid_joiner{
	dir = 8
	},
/obj/effect/turf_decal/siding/white{
	dir = 8
	},
/obj/structure/window/reinforced/spawner/directional/west,
/turf/open/floor/iron/large,
/area/shuttle/arrival)
"g" = (
/obj/machinery/light/directional/north,
/obj/effect/turf_decal/trimline/neutral/filled/warning/corner{
	dir = 1
	},
/turf/open/floor/iron,
/area/shuttle/arrival)
"h" = (
/obj/structure/closet/emcloset,
/obj/effect/turf_decal/trimline/neutral/filled/warning/corner{
	dir = 8
	},
/turf/open/floor/iron,
/area/shuttle/arrival)
"i" = (
/obj/structure/chair/comfy/shuttle{
	dir = 4
	},
/obj/effect/turf_decal/trimline/neutral/filled/mid_joiner{
	dir = 1
	},
/obj/effect/turf_decal/trimline/neutral/filled/line{
	dir = 9
	},
/obj/effect/turf_decal/trimline/neutral/filled/mid_joiner{
	dir = 8
	},
/obj/structure/window/reinforced/spawner/directional/west,
/obj/effect/turf_decal/siding/white{
	dir = 9
	},
/turf/open/floor/iron/large,
/area/shuttle/arrival)
"j" = (
/turf/open/floor/iron,
/area/shuttle/arrival)
"k" = (
/obj/effect/turf_decal/trimline/neutral/filled/warning{
	dir = 1
	},
/turf/open/floor/iron,
/area/shuttle/arrival)
"l" = (
/obj/machinery/requests_console/directional/north{
	department = "Arrival shuttle";
	name = "Arrival Shuttle Requests Console"
	},
/obj/effect/turf_decal/trimline/neutral/filled/warning/corner{
	dir = 4
	},
/turf/open/floor/iron,
/area/shuttle/arrival)
"m" = (
/obj/machinery/power/shuttle_engine/heater{
	dir = 4
	},
/obj/structure/window/reinforced/spawner/directional/west,
/turf/open/floor/plating/airless,
/area/shuttle/arrival)
"n" = (
/obj/machinery/power/shuttle_engine/propulsion/burst/right{
	dir = 4
	},
/turf/open/floor/plating/airless,
/area/shuttle/arrival)
"p" = (
/obj/structure/chair/comfy/shuttle,
/obj/effect/turf_decal/trimline/neutral/filled/line,
/obj/effect/turf_decal/trimline/neutral/filled/mid_joiner,
/obj/effect/turf_decal/siding/white,
/turf/open/floor/iron/large,
/area/shuttle/arrival)
"q" = (
/obj/machinery/light/small/directional/east,
/obj/structure/chair/comfy/shuttle,
/obj/effect/turf_decal/trimline/neutral/filled/line,
/obj/effect/turf_decal/trimline/neutral/filled/mid_joiner,
/obj/effect/turf_decal/siding/white,
/turf/open/floor/iron/large,
/area/shuttle/arrival)
"r" = (
/turf/open/floor/iron/large,
/area/shuttle/arrival)
"s" = (
/obj/machinery/power/shuttle_engine/propulsion{
	dir = 4
	},
/turf/open/floor/plating/airless,
/area/shuttle/arrival)
"t" = (
/obj/machinery/door/airlock/titanium{
	name = "Arrivals Shuttle Airlock"
	},
/obj/effect/turf_decal/trimline/neutral/filled/warning{
	dir = 8
	},
/obj/effect/turf_decal/trimline/neutral/filled/warning{
	dir = 4
	},
/obj/effect/turf_decal/trimline/neutral/mid_joiner{
	dir = 8
	},
/obj/effect/turf_decal/trimline/neutral/mid_joiner{
	dir = 4
	},
/turf/open/floor/iron/textured_large,
/area/shuttle/arrival)
"u" = (
/obj/machinery/power/shuttle_engine/propulsion{
	dir = 4
	},
/obj/docking_port/mobile/arrivals,
/turf/open/floor/plating/airless,
/area/shuttle/arrival)
"v" = (
/obj/structure/chair/comfy/shuttle{
	dir = 1
	},
/obj/effect/turf_decal/trimline/neutral/filled/line{
	dir = 1
	},
/obj/effect/turf_decal/trimline/neutral/filled/mid_joiner{
	dir = 1
	},
/obj/effect/turf_decal/siding/white{
	dir = 1
	},
/turf/open/floor/iron/large,
/area/shuttle/arrival)
"w" = (
/obj/machinery/light/small/directional/east,
/obj/structure/chair/comfy/shuttle{
	dir = 1
	},
/obj/effect/turf_decal/trimline/neutral/filled/line{
	dir = 1
	},
/obj/effect/turf_decal/trimline/neutral/filled/mid_joiner{
	dir = 1
	},
/obj/effect/turf_decal/siding/white{
	dir = 1
	},
/turf/open/floor/iron/large,
/area/shuttle/arrival)
"x" = (
/obj/structure/closet/wardrobe/black,
/obj/effect/turf_decal/trimline/neutral/filled/warning/corner,
/turf/open/floor/iron,
/area/shuttle/arrival)
"y" = (
/obj/machinery/light/directional/south,
/obj/effect/turf_decal/trimline/neutral/filled/warning/corner,
/turf/open/floor/iron,
/area/shuttle/arrival)
"z" = (
/obj/structure/closet/wardrobe/grey,
/obj/effect/turf_decal/trimline/neutral/filled/warning/corner{
	dir = 1
	},
/turf/open/floor/iron,
/area/shuttle/arrival)
"A" = (
/obj/machinery/power/shuttle_engine/propulsion/burst/left{
	dir = 4
	},
/turf/open/floor/plating/airless,
/area/shuttle/arrival)
"C" = (
/obj/structure/chair/comfy/shuttle{
	dir = 8
	},
/obj/effect/turf_decal/trimline/neutral/filled/line{
	dir = 6
	},
/obj/effect/turf_decal/trimline/neutral/filled/mid_joiner,
/obj/effect/turf_decal/trimline/neutral/filled/mid_joiner{
	dir = 4
	},
/obj/structure/window/reinforced/spawner/directional/east,
/obj/effect/turf_decal/siding/white{
	dir = 6
	},
/turf/open/floor/iron/large,
/area/shuttle/arrival)
"D" = (
/obj/effect/turf_decal/trimline/neutral/filled/warning{
	dir = 1
	},
/obj/effect/turf_decal/trimline/neutral/mid_joiner{
	dir = 1
	},
/turf/open/floor/iron/large,
/area/shuttle/arrival)
"E" = (
/obj/structure/chair/comfy/shuttle{
	dir = 8
	},
/obj/effect/turf_decal/trimline/neutral/filled/line{
	dir = 5
	},
/obj/effect/turf_decal/trimline/neutral/filled/mid_joiner{
	dir = 1
	},
/obj/effect/turf_decal/trimline/neutral/filled/mid_joiner{
	dir = 4
	},
/obj/structure/window/reinforced/spawner/directional/east,
/obj/effect/turf_decal/siding/white{
	dir = 5
	},
/turf/open/floor/iron/large,
/area/shuttle/arrival)
"F" = (
/obj/structure/chair/comfy/shuttle{
	dir = 4
	},
/obj/effect/turf_decal/trimline/neutral/filled/line{
	dir = 10
	},
/obj/effect/turf_decal/trimline/neutral/filled/mid_joiner,
/obj/effect/turf_decal/trimline/neutral/filled/mid_joiner{
	dir = 8
	},
/obj/structure/window/reinforced/spawner/directional/west,
/obj/effect/turf_decal/siding/white{
	dir = 10
	},
/turf/open/floor/iron/large,
/area/shuttle/arrival)
"G" = (
/obj/structure/chair/comfy/shuttle{
	dir = 4
	},
/obj/effect/turf_decal/trimline/neutral/filled/line{
	dir = 9
	},
/obj/effect/turf_decal/trimline/neutral/filled/mid_joiner{
	dir = 1
	},
/obj/effect/turf_decal/trimline/neutral/filled/mid_joiner{
	dir = 8
	},
/obj/structure/window/reinforced/spawner/directional/west,
/obj/effect/turf_decal/siding/white{
	dir = 9
	},
/turf/open/floor/iron/large,
/area/shuttle/arrival)
"H" = (
/obj/structure/chair/comfy/shuttle{
	dir = 4
	},
/obj/effect/turf_decal/trimline/neutral/filled/mid_joiner,
/obj/effect/turf_decal/trimline/neutral/filled/line{
	dir = 10
	},
/obj/effect/turf_decal/trimline/neutral/filled/mid_joiner{
	dir = 8
	},
/obj/structure/window/reinforced/spawner/directional/west,
/obj/effect/turf_decal/siding/white{
	dir = 10
	},
/turf/open/floor/iron/large,
/area/shuttle/arrival)
"J" = (
/obj/effect/turf_decal/trimline/neutral/filled/warning,
/turf/open/floor/iron,
/area/shuttle/arrival)
"K" = (
/obj/effect/turf_decal/trimline/neutral/filled/warning,
/obj/effect/turf_decal/trimline/neutral/mid_joiner,
/turf/open/floor/iron/large,
/area/shuttle/arrival)
"L" = (
/obj/structure/chair/comfy/shuttle{
	dir = 8
	},
/obj/effect/turf_decal/trimline/neutral/filled/line{
	dir = 4
	},
/obj/effect/turf_decal/trimline/neutral/filled/mid_joiner{
	dir = 4
	},
/obj/effect/turf_decal/siding/white{
	dir = 4
	},
/obj/structure/window/reinforced/spawner/directional/east,
/turf/open/floor/iron/large,
/area/shuttle/arrival)
"S" = (
/obj/effect/turf_decal/trimline/neutral/filled/warning{
	dir = 8
	},
/turf/open/floor/iron,
/area/shuttle/arrival)
"T" = (
/obj/structure/chair/comfy/shuttle{
	dir = 8
	},
/obj/effect/turf_decal/trimline/neutral/filled/mid_joiner{
	dir = 1
	},
/obj/effect/turf_decal/trimline/neutral/filled/line{
	dir = 5
	},
/obj/effect/turf_decal/trimline/neutral/filled/mid_joiner{
	dir = 4
	},
/obj/structure/window/reinforced/spawner/directional/east,
/obj/effect/turf_decal/siding/white{
	dir = 5
	},
/turf/open/floor/iron/large,
/area/shuttle/arrival)
"U" = (
/obj/item/radio/intercom/directional/south,
/obj/effect/turf_decal/trimline/neutral/filled/warning/corner{
	dir = 8
	},
/turf/open/floor/iron,
/area/shuttle/arrival)
"V" = (
/obj/machinery/door/airlock/titanium{
	name = "Arrivals Shuttle Airlock"
	},
/obj/structure/fans/tiny,
/obj/effect/turf_decal/stripes/line{
	dir = 1
	},
/obj/effect/turf_decal/trimline/neutral/filled/warning,
/turf/open/floor/iron/textured_large,
/area/shuttle/arrival)
"W" = (
/obj/structure/chair/comfy/shuttle{
	dir = 8
	},
/obj/effect/turf_decal/trimline/neutral/filled/mid_joiner,
/obj/effect/turf_decal/trimline/neutral/filled/line{
	dir = 6
	},
/obj/effect/turf_decal/trimline/neutral/filled/mid_joiner{
	dir = 4
	},
/obj/structure/window/reinforced/spawner/directional/east,
/obj/effect/turf_decal/siding/white{
	dir = 6
	},
/turf/open/floor/iron/large,
/area/shuttle/arrival)
"X" = (
/obj/effect/turf_decal/trimline/neutral/filled/warning{
	dir = 4
	},
/turf/open/floor/iron,
/area/shuttle/arrival)

(1,1,1) = {"
a
b
d
d
d
b
a
"}
(2,1,1) = {"
a
b
p
j
v
b
a
"}
(3,1,1) = {"
a
b
q
X
w
b
a
"}
(4,1,1) = {"
b
b
b
t
b
b
b
"}
(5,1,1) = {"
b
e
h
S
z
x
b
"}
(6,1,1) = {"
V
k
j
j
j
J
c
"}
(7,1,1) = {"
b
g
G
f
F
U
b
"}
(8,1,1) = {"
d
j
D
r
K
j
d
"}
(9,1,1) = {"
d
j
T
L
W
j
d
"}
(10,1,1) = {"
d
j
i
f
H
j
d
"}
(11,1,1) = {"
d
j
D
r
K
j
d
"}
(12,1,1) = {"
b
l
E
L
C
y
b
"}
(13,1,1) = {"
V
k
j
j
j
J
c
"}
(14,1,1) = {"
b
m
m
m
m
m
b
"}
(15,1,1) = {"
b
n
s
u
s
A
b
"}
