//MAP CONVERTED BY dmm2tgm.py THIS HEADER COMMENT PREVENTS RECONVERSION, DO NOT REMOVE
"b" = (
/turf/closed/wall/mineral/titanium,
/area/shuttle/supply)
"c" = (
/turf/open/floor/iron/dark/smooth_large,
/area/shuttle/supply)
"e" = (
/obj/effect/turf_decal/trimline/brown/filled/line,
/obj/effect/turf_decal/trimline/brown/filled/mid_joiner,
/turf/open/floor/iron/dark/smooth_large,
/area/shuttle/supply)
"f" = (
/obj/machinery/conveyor{
	dir = 4;
	id = "QMLoad2"
	},
/obj/machinery/door/poddoor{
	id = "QMLoaddoor2";
	name = "Supply Dock Loading Door"
	},
/turf/open/floor/plating,
/area/shuttle/supply)
"g" = (
/obj/machinery/door/airlock/titanium{
	name = "Supply Shuttle Airlock"
	},
/obj/effect/mapping_helpers/airlock/access/all/supply/general,
/obj/effect/turf_decal/trimline/brown/filled/warning{
	dir = 8
	},
/obj/effect/turf_decal/trimline/brown/mid_joiner{
	dir = 8
	},
/obj/effect/turf_decal/stripes/line{
	dir = 4
	},
/turf/open/floor/iron/dark/textured_large,
/area/shuttle/supply)
"h" = (
/obj/effect/turf_decal/trimline/brown/filled/line{
	dir = 4
	},
/obj/effect/turf_decal/trimline/brown/filled/mid_joiner{
	dir = 4
	},
/turf/open/floor/iron/dark/smooth_large,
/area/shuttle/supply)
"i" = (
/obj/machinery/door/airlock/titanium{
	name = "Supply Shuttle Airlock"
	},
/obj/docking_port/mobile/supply,
/obj/effect/mapping_helpers/airlock/access/all/supply/general,
/obj/effect/turf_decal/trimline/brown/filled/warning{
	dir = 8
	},
/obj/effect/turf_decal/trimline/brown/mid_joiner{
	dir = 8
	},
/obj/effect/turf_decal/stripes/line{
	dir = 4
	},
/turf/open/floor/iron/dark/textured_large,
/area/shuttle/supply)
"j" = (
/obj/machinery/conveyor{
	dir = 8;
	id = "QMLoad"
	},
/obj/machinery/door/poddoor{
	id = "QMLoaddoor";
	name = "Supply Dock Loading Door"
	},
/turf/open/floor/plating,
/area/shuttle/supply)
"l" = (
/turf/closed/wall/mineral/titanium/interior,
/area/shuttle/supply)
"m" = (
/obj/effect/turf_decal/trimline/brown/filled/line{
	dir = 9
	},
/obj/effect/turf_decal/trimline/brown/filled/mid_joiner{
	dir = 8
	},
/obj/effect/turf_decal/trimline/brown/filled/mid_joiner{
	dir = 1
	},
/turf/open/floor/iron/dark/smooth_large,
/area/shuttle/supply)
"o" = (
/obj/effect/turf_decal/trimline/brown/filled/line{
	dir = 1
	},
/obj/effect/turf_decal/trimline/brown/filled/mid_joiner{
	dir = 1
	},
/turf/open/floor/iron/dark/smooth_large,
/area/shuttle/supply)
"p" = (
/obj/structure/window/reinforced/spawner/directional/north,
/obj/machinery/power/shuttle_engine/heater,
/turf/open/floor/plating/airless,
/area/shuttle/supply)
"r" = (
/obj/effect/turf_decal/trimline/brown/filled/corner,
/turf/open/floor/iron/dark/smooth_large,
/area/shuttle/supply)
"s" = (
/turf/template_noop,
/area/template_noop)
"t" = (
/obj/machinery/power/shuttle_engine/propulsion/burst/left,
/turf/open/floor/plating/airless,
/area/shuttle/supply)
"u" = (
/obj/machinery/power/shuttle_engine/propulsion,
/turf/open/floor/plating/airless,
/area/shuttle/supply)
"v" = (
/obj/machinery/power/shuttle_engine/propulsion/burst/right,
/turf/open/floor/plating/airless,
/area/shuttle/supply)
"x" = (
/obj/machinery/light/directional/west,
/obj/effect/turf_decal/trimline/brown/filled/line{
	dir = 8
	},
/obj/effect/turf_decal/trimline/brown/filled/mid_joiner{
	dir = 8
	},
/turf/open/floor/iron/dark/smooth_large,
/area/shuttle/supply)
"y" = (
/obj/effect/turf_decal/trimline/brown/filled/line{
	dir = 5
	},
/obj/effect/turf_decal/trimline/brown/filled/mid_joiner{
	dir = 4
	},
/obj/effect/turf_decal/trimline/brown/filled/mid_joiner{
	dir = 1
	},
/turf/open/floor/iron/dark/smooth_large,
/area/shuttle/supply)
"C" = (
/obj/machinery/light/directional/east,
/obj/effect/turf_decal/trimline/brown/filled/line{
	dir = 6
	},
/obj/effect/turf_decal/trimline/brown/filled/mid_joiner,
/obj/effect/turf_decal/trimline/brown/filled/mid_joiner{
	dir = 4
	},
/turf/open/floor/iron/dark/smooth_large,
/area/shuttle/supply)
"D" = (
/obj/effect/turf_decal/trimline/brown/filled/corner{
	dir = 8
	},
/turf/open/floor/iron/dark/smooth_large,
/area/shuttle/supply)
"F" = (
/obj/machinery/button/door/directional/east{
	id = "QMLoaddoor2";
	name = "Loading Doors";
	pixel_y = 8
	},
/obj/machinery/button/door/directional/east{
	id = "QMLoaddoor";
	name = "Loading Doors";
	pixel_y = -8
	},
/obj/effect/turf_decal/trimline/brown/filled/warning{
	dir = 4
	},
/obj/effect/turf_decal/trimline/brown/mid_joiner{
	dir = 4
	},
/turf/open/floor/iron/dark/smooth_large,
/area/shuttle/supply)
"L" = (
/obj/effect/turf_decal/trimline/brown/filled/warning{
	dir = 4
	},
/obj/effect/turf_decal/trimline/brown/mid_joiner{
	dir = 4
	},
/turf/open/floor/iron/dark/smooth_large,
/area/shuttle/supply)
"S" = (
/obj/effect/turf_decal/trimline/brown/filled/line{
	dir = 10
	},
/obj/effect/turf_decal/trimline/brown/filled/mid_joiner,
/obj/effect/turf_decal/trimline/brown/filled/mid_joiner{
	dir = 8
	},
/turf/open/floor/iron/dark/smooth_large,
/area/shuttle/supply)
"T" = (
/obj/effect/turf_decal/trimline/brown/filled/line{
	dir = 8
	},
/obj/effect/turf_decal/trimline/brown/filled/mid_joiner{
	dir = 8
	},
/turf/open/floor/iron/dark/smooth_large,
/area/shuttle/supply)
"V" = (
/obj/effect/turf_decal/trimline/brown/filled/line{
	dir = 6
	},
/obj/effect/turf_decal/trimline/brown/filled/mid_joiner,
/obj/effect/turf_decal/trimline/brown/filled/mid_joiner{
	dir = 4
	},
/turf/open/floor/iron/dark/smooth_large,
/area/shuttle/supply)

(1,1,1) = {"
b
b
b
b
b
b
b
b
b
b
b
s
"}
(2,1,1) = {"
b
m
x
T
T
T
T
T
S
l
b
t
"}
(3,1,1) = {"
b
o
c
c
c
c
c
c
D
S
p
u
"}
(4,1,1) = {"
b
o
c
c
c
c
c
c
c
e
p
u
"}
(5,1,1) = {"
b
o
c
c
c
c
c
c
r
V
p
u
"}
(6,1,1) = {"
b
y
h
L
L
F
L
L
C
l
b
v
"}
(7,1,1) = {"
b
b
b
f
g
b
i
j
b
b
b
s
"}
