//MAP CONVERTED BY dmm2tgm.py THIS HEADER COMMENT PREVENTS RECONVERSION, DO NOT REMOVE
"a" = (
/turf/closed/wall/mineral/titanium,
/area/shuttle/mining)
"e" = (
/obj/machinery/door/airlock/titanium{
	name = "Lavaland Shuttle Airlock"
	},
/obj/docking_port/mobile{
	dir = 8;
	shuttle_id = "mining_common";
	name = "lavaland shuttle";
	port_direction = 4
	},
/obj/effect/turf_decal/trimline/neutral/mid_joiner{
	dir = 8
	},
/obj/effect/turf_decal/trimline/neutral/filled/warning{
	dir = 8
	},
/obj/effect/turf_decal/stripes/line{
	dir = 4
	},
/obj/effect/turf_decal/trimline/yellow/mid_joiner{
	dir = 8
	},
/obj/effect/turf_decal/trimline/yellow/warning{
	dir = 8
	},
/turf/open/floor/iron/textured_large,
/area/shuttle/mining)
"g" = (
/obj/machinery/light/directional/west,
/obj/effect/turf_decal/trimline/neutral/filled/line{
	dir = 8
	},
/obj/effect/turf_decal/trimline/neutral/filled/mid_joiner{
	dir = 8
	},
/obj/effect/turf_decal/trimline/yellow/line{
	dir = 8
	},
/obj/effect/turf_decal/trimline/yellow/mid_joiner{
	dir = 8
	},
/turf/open/floor/iron/edge{
	dir = 8
	},
/area/shuttle/mining)
"j" = (
/obj/effect/turf_decal/trimline/neutral/filled/warning{
	dir = 4
	},
/obj/effect/turf_decal/trimline/neutral/mid_joiner{
	dir = 4
	},
/obj/effect/turf_decal/trimline/yellow/warning{
	dir = 4
	},
/obj/effect/turf_decal/trimline/yellow/mid_joiner{
	dir = 4
	},
/turf/open/floor/iron/edge{
	dir = 4
	},
/area/shuttle/mining)
"n" = (
/obj/machinery/power/shuttle_engine/propulsion/burst,
/turf/open/floor/plating/airless,
/area/shuttle/mining)
"q" = (
/obj/effect/turf_decal/trimline/neutral/filled/line{
	dir = 9
	},
/obj/effect/turf_decal/trimline/neutral/filled/mid_joiner{
	dir = 8
	},
/obj/effect/turf_decal/trimline/neutral/filled/mid_joiner{
	dir = 1
	},
/obj/effect/turf_decal/trimline/yellow/line{
	dir = 9
	},
/obj/effect/turf_decal/trimline/yellow/mid_joiner{
	dir = 1
	},
/turf/open/floor/iron/corner,
/area/shuttle/mining)
"r" = (
/obj/structure/table,
/obj/effect/turf_decal/siding/white,
/obj/effect/turf_decal/trimline/neutral/filled/line,
/obj/effect/turf_decal/trimline/neutral/filled/mid_joiner,
/obj/effect/turf_decal/trimline/yellow/line,
/obj/effect/turf_decal/trimline/yellow/mid_joiner,
/obj/item/gps{
	pixel_w = -5;
	pixel_z = 5
	},
/obj/item/gps{
	pixel_w = 4;
	pixel_z = 2
	},
/turf/open/floor/iron/large,
/area/shuttle/mining)
"t" = (
/obj/structure/table,
/obj/effect/turf_decal/siding/white,
/obj/effect/turf_decal/trimline/neutral/filled/line,
/obj/effect/turf_decal/trimline/neutral/filled/mid_joiner,
/obj/effect/turf_decal/trimline/yellow/line,
/obj/effect/turf_decal/trimline/yellow/mid_joiner,
/obj/item/storage/fancy/donut_box{
	pixel_w = 0;
	pixel_z = 5
	},
/turf/open/floor/iron/large,
/area/shuttle/mining)
"w" = (
/obj/machinery/computer/shuttle/mining,
/obj/effect/turf_decal/siding/white,
/obj/effect/turf_decal/trimline/neutral/filled/line,
/obj/effect/turf_decal/trimline/neutral/filled/mid_joiner,
/obj/effect/turf_decal/trimline/yellow/line,
/obj/effect/turf_decal/trimline/yellow/mid_joiner,
/turf/open/floor/iron/large,
/area/shuttle/mining)
"y" = (
/turf/open/floor/iron/large,
/area/shuttle/mining)
"A" = (
/obj/effect/turf_decal/trimline/neutral/filled/line{
	dir = 5
	},
/obj/effect/turf_decal/trimline/neutral/filled/mid_joiner{
	dir = 4
	},
/obj/effect/turf_decal/trimline/neutral/filled/mid_joiner{
	dir = 1
	},
/obj/effect/turf_decal/trimline/yellow/line{
	dir = 5
	},
/obj/effect/turf_decal/trimline/yellow/mid_joiner{
	dir = 1
	},
/turf/open/floor/iron/corner{
	dir = 8
	},
/area/shuttle/mining)
"B" = (
/obj/structure/chair/comfy/shuttle{
	dir = 1
	},
/obj/effect/turf_decal/trimline/neutral/filled/line{
	dir = 6
	},
/obj/effect/turf_decal/trimline/neutral/filled/mid_joiner,
/obj/effect/turf_decal/trimline/neutral/filled/mid_joiner{
	dir = 4
	},
/obj/effect/turf_decal/trimline/yellow/line{
	dir = 6
	},
/obj/effect/turf_decal/trimline/yellow/mid_joiner,
/turf/open/floor/iron/corner{
	dir = 1
	},
/area/shuttle/mining)
"C" = (
/obj/structure/chair/comfy/shuttle{
	dir = 1
	},
/obj/effect/turf_decal/trimline/neutral/filled/line,
/obj/effect/turf_decal/trimline/neutral/filled/mid_joiner,
/obj/effect/turf_decal/trimline/yellow/line,
/obj/effect/turf_decal/trimline/yellow/mid_joiner,
/turf/open/floor/iron/edge,
/area/shuttle/mining)
"M" = (
/obj/structure/chair/comfy/shuttle{
	dir = 1
	},
/obj/effect/turf_decal/trimline/neutral/filled/line{
	dir = 10
	},
/obj/effect/turf_decal/trimline/neutral/filled/mid_joiner,
/obj/effect/turf_decal/trimline/neutral/filled/mid_joiner{
	dir = 8
	},
/obj/effect/turf_decal/trimline/yellow/line{
	dir = 10
	},
/obj/effect/turf_decal/trimline/yellow/mid_joiner,
/turf/open/floor/iron/corner{
	dir = 4
	},
/area/shuttle/mining)
"N" = (
/obj/structure/ore_box,
/obj/effect/turf_decal/siding/white{
	dir = 1
	},
/obj/effect/turf_decal/trimline/neutral/filled/line{
	dir = 1
	},
/obj/effect/turf_decal/trimline/neutral/filled/mid_joiner{
	dir = 1
	},
/obj/effect/turf_decal/trimline/yellow/line{
	dir = 1
	},
/obj/effect/turf_decal/trimline/yellow/mid_joiner{
	dir = 1
	},
/turf/open/floor/iron/large,
/area/shuttle/mining)
"Q" = (
/obj/structure/chair/comfy/shuttle{
	dir = 1
	},
/obj/effect/turf_decal/trimline/neutral/filled/line{
	dir = 1
	},
/obj/effect/turf_decal/trimline/neutral/filled/mid_joiner{
	dir = 1
	},
/obj/effect/turf_decal/trimline/yellow/line{
	dir = 1
	},
/obj/effect/turf_decal/trimline/yellow/mid_joiner{
	dir = 1
	},
/turf/open/floor/iron/edge{
	dir = 1
	},
/area/shuttle/mining)
"R" = (
/obj/machinery/power/shuttle_engine/heater,
/obj/structure/window/reinforced/spawner/directional/north,
/obj/structure/window/reinforced/spawner/directional/west,
/obj/structure/window/reinforced/spawner/directional/east,
/turf/open/floor/plating,
/area/shuttle/mining)
"S" = (
/obj/effect/spawner/structure/window/reinforced/shuttle,
/turf/open/floor/plating,
/area/shuttle/mining)
"V" = (
/obj/structure/closet/crate,
/obj/effect/turf_decal/siding/white{
	dir = 1
	},
/obj/effect/turf_decal/trimline/neutral/filled/line{
	dir = 1
	},
/obj/effect/turf_decal/trimline/neutral/filled/mid_joiner{
	dir = 1
	},
/obj/effect/turf_decal/trimline/yellow/line{
	dir = 1
	},
/obj/effect/turf_decal/trimline/yellow/mid_joiner{
	dir = 1
	},
/turf/open/floor/iron/large,
/area/shuttle/mining)

(1,1,1) = {"
a
a
S
a
S
a
a
"}
(2,1,1) = {"
a
t
q
g
M
V
a
"}
(3,1,1) = {"
S
w
Q
y
C
R
n
"}
(4,1,1) = {"
a
r
A
j
B
N
a
"}
(5,1,1) = {"
a
a
S
e
S
a
a
"}
