//MAP CONVERTED BY dmm2tgm.py THIS HEADER COMMENT PREVENTS RECONVERSION, DO NOT REMOVE
"a" = (
/turf/closed/wall/mineral/titanium,
/area/shuttle/mining)
"b" = (
/obj/effect/spawner/structure/window/reinforced/shuttle,
/turf/open/floor/plating,
/area/shuttle/mining)
"c" = (
/obj/structure/table,
/obj/effect/turf_decal/trimline/yellow/filled/line,
/obj/effect/turf_decal/trimline/yellow/filled/mid_joiner,
/obj/effect/turf_decal/siding/white,
/obj/item/storage/fancy/donut_box{
	pixel_w = 0;
	pixel_z = 5
	},
/turf/open/floor/iron/large,
/area/shuttle/mining)
"d" = (
/obj/machinery/computer/shuttle/mining,
/obj/effect/turf_decal/trimline/yellow/filled/line,
/obj/effect/turf_decal/trimline/yellow/filled/mid_joiner,
/obj/effect/turf_decal/siding/white,
/turf/open/floor/iron/large,
/area/shuttle/mining)
"e" = (
/obj/effect/turf_decal/trimline/yellow/filled/line{
	dir = 9
	},
/obj/effect/turf_decal/trimline/yellow/filled/mid_joiner{
	dir = 8
	},
/obj/effect/turf_decal/trimline/yellow/filled/mid_joiner{
	dir = 1
	},
/turf/open/floor/iron/corner,
/area/shuttle/mining)
"f" = (
/obj/structure/chair/comfy/shuttle{
	dir = 1
	},
/obj/effect/turf_decal/trimline/yellow/filled/line,
/obj/effect/turf_decal/trimline/yellow/filled/mid_joiner,
/turf/open/floor/iron/edge,
/area/shuttle/mining)
"g" = (
/obj/machinery/light/directional/west,
/obj/effect/turf_decal/trimline/yellow/filled/line{
	dir = 8
	},
/obj/effect/turf_decal/trimline/yellow/filled/mid_joiner{
	dir = 8
	},
/turf/open/floor/iron/edge{
	dir = 8
	},
/area/shuttle/mining)
"h" = (
/obj/machinery/door/airlock/titanium{
	name = "Mining Shuttle Airlock"
	},
/obj/docking_port/mobile{
	dir = 8;
	shuttle_id = "mining";
	name = "mining shuttle";
	port_direction = 4
	},
/obj/effect/turf_decal/stripes/line{
	dir = 4
	},
/obj/effect/turf_decal/trimline/yellow/filled/warning{
	dir = 8
	},
/obj/effect/turf_decal/trimline/yellow/mid_joiner{
	dir = 8
	},
/turf/open/floor/iron/textured_large,
/area/shuttle/mining)
"i" = (
/obj/structure/closet/crate,
/obj/effect/turf_decal/trimline/yellow/filled/line{
	dir = 1
	},
/obj/effect/turf_decal/trimline/yellow/filled/mid_joiner{
	dir = 1
	},
/obj/effect/turf_decal/siding/white{
	dir = 1
	},
/turf/open/floor/iron/large,
/area/shuttle/mining)
"j" = (
/obj/machinery/power/shuttle_engine/heater,
/obj/structure/window/reinforced/spawner/directional/north,
/obj/structure/window/reinforced/spawner/directional/west,
/obj/structure/window/reinforced/spawner/directional/east,
/turf/open/floor/plating,
/area/shuttle/mining)
"k" = (
/obj/structure/ore_box,
/obj/effect/turf_decal/trimline/yellow/filled/line{
	dir = 1
	},
/obj/effect/turf_decal/trimline/yellow/filled/mid_joiner{
	dir = 1
	},
/obj/effect/turf_decal/siding/white{
	dir = 1
	},
/turf/open/floor/iron/large,
/area/shuttle/mining)
"l" = (
/obj/machinery/power/shuttle_engine/propulsion/burst,
/turf/open/floor/plating/airless,
/area/shuttle/mining)
"s" = (
/obj/structure/chair/comfy/shuttle{
	dir = 1
	},
/obj/effect/turf_decal/trimline/yellow/filled/line{
	dir = 10
	},
/obj/effect/turf_decal/trimline/yellow/filled/mid_joiner,
/obj/effect/turf_decal/trimline/yellow/filled/mid_joiner{
	dir = 8
	},
/turf/open/floor/iron/corner{
	dir = 4
	},
/area/shuttle/mining)
"u" = (
/obj/effect/turf_decal/trimline/yellow/filled/line{
	dir = 5
	},
/obj/effect/turf_decal/trimline/yellow/filled/mid_joiner{
	dir = 4
	},
/obj/effect/turf_decal/trimline/yellow/filled/mid_joiner{
	dir = 1
	},
/turf/open/floor/iron/corner{
	dir = 8
	},
/area/shuttle/mining)
"v" = (
/turf/open/floor/iron/large,
/area/shuttle/mining)
"G" = (
/obj/effect/turf_decal/trimline/yellow/filled/warning{
	dir = 4
	},
/obj/effect/turf_decal/trimline/yellow/mid_joiner{
	dir = 4
	},
/turf/open/floor/iron/edge{
	dir = 4
	},
/area/shuttle/mining)
"Q" = (
/obj/structure/chair/comfy/shuttle{
	dir = 1
	},
/obj/effect/turf_decal/trimline/yellow/filled/line{
	dir = 1
	},
/obj/effect/turf_decal/trimline/yellow/filled/mid_joiner{
	dir = 1
	},
/turf/open/floor/iron/edge{
	dir = 1
	},
/area/shuttle/mining)
"R" = (
/obj/structure/table,
/obj/effect/turf_decal/trimline/yellow/filled/line,
/obj/effect/turf_decal/trimline/yellow/filled/mid_joiner,
/obj/effect/turf_decal/siding/white,
/obj/item/gps{
	pixel_w = -5;
	pixel_z = 5
	},
/obj/item/gps{
	pixel_w = 4;
	pixel_z = 2
	},
/turf/open/floor/iron/large,
/area/shuttle/mining)
"T" = (
/obj/structure/chair/comfy/shuttle{
	dir = 1
	},
/obj/effect/turf_decal/trimline/yellow/filled/line{
	dir = 6
	},
/obj/effect/turf_decal/trimline/yellow/filled/mid_joiner,
/obj/effect/turf_decal/trimline/yellow/filled/mid_joiner{
	dir = 4
	},
/turf/open/floor/iron/corner{
	dir = 1
	},
/area/shuttle/mining)

(1,1,1) = {"
a
a
b
a
b
a
a
"}
(2,1,1) = {"
a
c
e
g
s
i
a
"}
(3,1,1) = {"
b
d
Q
v
f
j
l
"}
(4,1,1) = {"
a
R
u
G
T
k
a
"}
(5,1,1) = {"
a
a
b
h
b
a
a
"}
